0000011000000000000000100000
0000011000000000000000100000
0001111111111110000001110000
0001111111111110000000100000
0011111111111111000001110000
0011111111111111000011111000
0111111111111111100001110000
0001100011000110000011111000
0001100011000110000111111100
0001100011000110000011111000
0001111111111110001111111110
0001111111111110000111111100
1111111111111111111111111111
