111101111
111100111
111100011
111100011
111101011
111101011
111101011
111100111
110001111
100101111
001100011
001001001
001001100
001101100
001101100
100101001
110000011
111101111
111101111
111001111
