111110000001111
111110100100110
111110001110000
111111011111001
111000000011111
011111011111011
001111011110011
000111011100011
010111011101011
001111011110011
000110001100011
100000000000111
110000000001111
111110001111111
111111011111111
