000110000011000
001111000111100
011111101111110
111111111111111
100011010110101
110110000010101
110111000110101
100011101111011
011111111111110
001111111111100
000111111111000
000011111110000
000001111100000
000000111000000
000000010000000
