0111011111001110
0010010101010010
0010000100011110
0010000100010010
0111000100010010