0000100000
0001110000
1111111011
1011111110
0111111100
0011111000
0001110000
