000000000110000000
000011111111110000
000111111111111000
001111111111111100
011111111111111110
001000000000000100
001000000000000100
001001110011100100
001001110011100100
111001110011100111
111000000011100111
111000000011100111
111111111111111111
