000111110000000000000000000000
001111111000000000000000000000
011100011100000000000000000000
111000001110000000000000000000
111000000110000000000000000000
111000000111111111111111111111
111000000111111111111111111111
111000000110000000000001101011
111000001110000000000001101011
011100011100000000000001100011
001111111000000000000000000000
000111110000000000000000000000
