00011000011111000
00111000111111100
01111000110001100
00011000000001100
00011000000011000
00011000000011000
00011000000001100
00011000110001100
01111110111111100
01111110011110000
