000010000000000
000010000000000
000011000000000
000011100000000
000011110000000
000011111000000
000011111100000
000011111110000
000011111111000
000011111111100
000011111111110
111111111111111
000010000000000
111111111111111
011111111111110
001111111111100
