1111000001111000011111
1110000110000100001111
1100011110000110001111
1100011111111110011001
1100011000000011110001
1110001000000001000011
0001001000000011000011
1000111110000110000111
1100000011111000001111
1110000000110000011111
1111110000111111111111
1111111111100111111111
1000000011100111111111
1100000001100111111111
1110000000100111110000
1111000001100111000000
1111111111100110000001
1111111111100100000011
1111111111100111111111
1111111111100111111111