11100011111111111111000111111111111111111111111111
11100001111111111111000011111111111111111111111111
11101100001111111000010011111111111111111111111111
11101110000000000000110011111111111111111111111111
11100111000000000001110011111111111111111111111111
11110000000000000000000011111111111111111111111111
11110000000000000000000111111111111111111111111111
11110000000000000000000111111111111111111111111111
11110000000000000000000011111111111111111111111111
11111000000000000000000011111111111111111111111111
11110010001100000110001000111111111111111111111111
11110011000000000000111000001111111111111111111111
11110011111000000001111000000001111111111111111111
11110011111110010111111000000000111111111111111111
11110001111111101111110000000000001111111111111111
11111001111111111111110000000000000001111111111111
11111100111111111111100000000000000000011111111111
11111110001111111001000000000000000000001111111111
11111111100111110000000000000000000000000111111111
11111111100110000000000000000000000000000011111111
11111111100100000000100000000000000000000011111111
11111111100100000000110000000000000000000000111111
11111111000100000000111000000000000000000000111111
11111111000100000000101100000000000000000000111111
11111111000110000000100110000000000000000000111111
11111111000111000000100000000000000000000000111111
11111110000000000000000000000000000000000001111111
00000010010000000000000000000000000000000010000000


