000111000011100
000011100111000
000001111110000
000000011000000
001111111111100
011111111111110
111111111111011
111111111110001
111111111110001
111111111111011
111111111111111
111111111111111
011111111111110
001111111111100
000111101111000
