0000000000001100000000000000001100000000000
0000000000001110000000000000000110000000000
0010000001111111000000000000000011000000000
0011001111111111100000000000000011100000000
0011111111111111100000000000000001110000000
0001111111111111000011111111110000111000000
0001111111111111001111111111111000111000000
0000111111111110111111111111111101111000000
0000000111111110111111111111111101110000000
0000000001111111111111111111111111110000000
0000000000111111111111111111111111000000000
0000000000011111111100000001111110000000000
0101000000001111110000000000011111000010000
1001000010000111100100010000001111000010001
1000100010000011100100100001000111000100010
1111111111111111111111111111111111111111111