000001111111111111111111111111111000000
000011111000000000000000000001111100000
000111100000000000000000000000111110000
001111000001111000000011110000001110000
001110000011111100000111111000001111000
011110000011111100000111111000000111000
011100000001111000000011110000000111100
011100000000000000000000000000000011100
011100000000000000000000000000000011100
011100001100000000000000000110000011100
011100001110000000000000000110000111100
011110000111000000000000001110000111000
001110000111100000000000111100001111000
001111000011111100000111111000001110000
000111100001111111111111110000111110000
000011110000011111111111000001111100000
000001111100000000000000000111111000000
000000111111111111111111111111100000000
000000001111111111111111111110000000000