000000000000000000000000000000000000000
000011111110000001111100000011111110000
000011000111111111111111111110000110000
000011000011111111111111111100000110000
000001111111111111111111111111111100000
000000111111111111111111111111111000000
000000111111111111111111111111111000000
000000111111111111111111111111111000000
000000111110000001111110000001111000000
000000111100001101111110110000111100000
011111111100001001111110010001111111110
000000011111000111000111100011100000000
000000011111111111101111111111111100000
000111100001111111111111111110000111000
000000000000000111111111100000000000000
000000000000011111111111110000000000000
000000000000111111111111111000001100000