00000000000000000000000000000000000000000000000000
00000000000000000000000000000001111000000000000000
00000000000000000000000000011111111111000000000010
00000000000000000000111111111111111111100000000010
00000000111111111111111111111111111111100000000110
00000111111111111111111111111111111101111111001110
00001111111111111111111111111111111111111111111110
00011111111111111111111111111111111111111111111100
00111111111111111111111111111111111111111111111000
00111111111111111111111111111111111111111111111000
01111111111111111111111111111111111111111111111000
01111111111111111111111111111111000000111111110000
01111111111111111111111111111111000000000000000000
01111101111111111111111100111110000000000000000000
01111001110000000000111100111100000000000000000000
01110001110000000000111100111100000000000000000000
00111001111000000000111000111000000000000000000000
01111100111000000000111100111110000000000000000000
00000000000000000000111110111110000000000000000000