000000000000000000000000011111110000000000000000
000000000000000000000000111111111100000000000000
000000000000000000000000111111111110000000000000
000000000000000000000000011111111111111000000000
000000000000000000000000001111111111100000000000
000000000000000000000000000001111111111111000000
000000000000000000000000000111111111100000000000
000000000000000000000000011111111111111100000000
000000000000000011100000011111111111111000000000
000000000000001111111100000111111001111100000000
000000000000011111111110000011110000111110000000
000000000001111110111111110011110000001111000000
000000000011111000001111111101111000000011100000
000000001111100000000011111111111100000001110000
000000011100000000000001111111111100000000111000
000001110000000000000000111111111100000000111111
111111111111111111111111111111111111111111111111