001111100
011111110
111111111
000010000
000010000
001010000
001110000

