0000000011110000000
0000001111111110000
0000001111111010000
0000011111111110000
0000011111111111000
0000011111101111100
0000111111100000111
0000111111110000010
0000111111111100000
1000011111111110000
1100011111111111000
1110001111111111100
1111100011111111100
1111111111111111100
1111111111111111000
1111111111111110000
1111111111111000000
1110011111100000000
1100111111000000000
1000111110000000000
0001111110000111000
0001111110001101100
0000111110001001100
0000111110000001100
0000011111000011100
0000000111111111000
0000000000111100000