1111111111111111111111111111111111111111 
1111111111111111000000000000001111111111 
1111111111111100111111111111000011111111 
1111111111111111111111111111110011111111 
1111111111111111111111111111111100111111 
1111111111111111111111111111111100111111 
1111111111111111111111111111111111001111 
1111111111111111111111111111111111001111 
1111001111111111001111000000111111001111 
1111110011111100111100000000001111001111 
1111110000000000111100000000000011001111 
1111110000000000110000000000000000111111 
1111110011001100000000000000000011111111 
1111110000110000000000000000001111111111 
1111111100000000000000110000001111111111 
1111111100000000000011110000001111111111 
1111111100000011111111111100000011111111 
1111111111001111111111111111000011111111 
1111111111001111111111111111110011111111 
1111111111001111111111111111110011111111 
1111111100001111111111111111000011111111 
1111111100001111111111111111000011111111 
1111111111111111111111111111111111111111 