1111111111111111111111000000000111111111 
1100000001111111111000111111110001111111 
1101111110111111100011111111111110001111 
1110111111011110011111111111111111110011 
1111011111011100111110011111100111110001 
1111101110111011111100001111000011111100 
1110000000000000111111111111111111111100 
1110111111111111011111111101111111111100 
1001111111111111011100111111111100111100 
0011100000000000111110011111111001111100 
0111111111111111011111100000000111111100 
0011111111111111011111111111111111111001 
1011100000000000111111111111111111100111 
1001111111111000011111111111111111011111 
1100000000000011100000000000000000111111