00000000000000000011111111111111000000000000000
00000000000000111111111111111111111100000000000
00000000000000011111111111111111111000000000000
00000000000000001111111111111111110000000000000
00000000000000000111111111111111100000000000000
00000000000000000011111111111111000000000000000
00000000000000000001111111111110000000000000000
00000000000000000000111111111100000000000000000
00000000000000000000000000000000000000000000000
00000000000000000000000111100000000000000000000
00000000000000000000001111110000000000000000000
00011111111111111111001111110011111111111111111
00011111111111111111000111100011111111111111111
00001111111111111111100000000111111111111111110
00000111111111111111111000011111111111111111100
00000011111111111111110000001111111111111111000
00000000111111111111100000000111111111111100000
00000000001111111111000000000011111111110000000
00000000000011111110000000000001111111000000000
00000000000000011100000000000000111000000000000