11001111111111111111111111111111111111
10000011111111111111111111111111111111
10000000111111111111111111111111111111
11000000001111111111111111111111111111
11100010000001111111111111110000001111
11100111100000000001111111000000000111
11100111110000000000111100000000000111
11111111111111111111110000000000000111
11111111111111111111100000000000001111
11111111111111111111000000000000011111
11111111111111111110000000000000111111
11111111111111111100000000110000111111
11111111111111111000000011110001111111
11111111111111100000000111110001111111
11111111111110000000001111110001111111
11111110000000000000011111110001111111
11110000000000000000111111110001111111
10000000000000000001111111110001111111