1111111111111110111111111111111 
1111111111111100011111111111111 
1111111111111000001111111111111 
1111111111110000000111111111111 
1111111111100000000011111111111 
1000000000000010100000000000001 
1110000000000000000000000000111 
1111100000011000011000000011111 
1111111000001111110000001111111 
1111110000000000000000000111111 
1111100000001111111000000011111 
1111000001111111111111000001111 
1110001111111111111111111000111 
1101111111111111111111111111011