00111000000000000000000011110000
00111110000000000000000111110000
00111111000000000000001111110000
00011111110000000000011111110000
00000111111110000000111111110000
00000011111111100000111111100000
00000000111111110000111111100000
00000000011111111100111111000000
00000000000011111111111110000000
00000000000000011111111100000000
00000000001111111111111000000000
00000000111111111111111100000000
00000001110001111111111110000000
00000011111011111111111110000000
00000111111111111111111110000000
00000011111111111111111110000000
00000001111111111111111100000000
00000000000111111111111100000000
00000000001111111111110000000000