1111111100001111111111111111111111 
1111110000111111111111111111111111 
1111000001111111111111111111111111 
1110000011111111111111111111111111 
1100000011111111111111111111111111 
1000000011111111111111111111111111 
1000000011111111111111111111111111 
1000011001111111111111111111111111 
1000011000000001111111111111111111 
1000000000000111111111111111111111 
1100000000001111111111111111110011 
1110000110000011111111111111111001 
1111000001111111011111111111100011 
1111110000001100000111111000000111 
1111111100000000000000000000011111 
1111111111000000000000000001111111 
1111111111111100000000011111111111