1111111111111110001111111111111111
1111111111111000000011111111111111
1111111111111110001111111111111111
1111111111111000000001111111111111
1111111111100010001000111111111111
1111111000000110000011000000111111
1111100001111001001100111100001111
1110010111100011001110001111000111
1100011110011110000111100111100011
1100011100111110000111110001100011
1100011000111100000011110001100011
1100011000111100000011110001100011
1110001100011110000111000111000111
1111001111001111001111001110001111
1111100111100111001110011100011111
1111111001110011001110011100111111
1111111100110011001110011001111111
1111111100000000000000000011111111
1111111100000000000000000011111111