00001100000
00011100000
00010000000
01110111100
10111111110
11111111110
00011001111
00111010111