000000000000111111111111111000000000000 
000000000111111111111111111111000000000 
000000011111111111111111111111110000000 
000001111111111111111111111111111100000 
000011111110001111111111100011111110000 
001111111100000111111111000001111111100 
011111111110001111111111100011111111110 
011111111111111111111111111111111111110 
111111111111111111111111111111111111111 
111111111111111111111111111111111111111 
111111111111111001111100111111111111111 
111110011111111101111101111111110011110 
011110011111111111111111111111110011110 
001111001111111111111111111111100111100 
000011100111111111111111111111001110000 
000001111000000000000000000000111100000 
000000011100000000000000000011110000000 
000000000111111000000000111111000000000 
000000000000111111111111111000000000000 
000000000000000000000000000000000000000