111111110000111111100001111111000001111000011111111111
111111100111100111000000001100000000010011110011111111
111111001100111100000000000000000000001111001100111111
111110011001100100000000000000000000001001100110011111
111100110011001110000000000000000000011100110011001111
111100101010101011100000000000000001110101010101001111
111001110101011111111000000000000111111110101011100111
111001101011111111111100000000000111111111110101100111
110011011111111111111111000000011111111111111110110011
110001111111111111111111110001111111111111111111100011
110111111111111111111111111011111111111111111111111001