000000000000000000000000000000011111000000
111111111111110000000011100000011111000000
011111111111110000000111110000001110000000
001100001000110000000111110000001110011000
001100001000111111111111111111111111111100
001111111111110111110111111111011111101110
001111111111110111110011111111001111110110
001111111111110111111011111111101111110100
000111111111110111110011111111001111101100
000111111111111111111111111111111111111110
000001001111100010011111100011001111001111
000000111111000001111111000001111100000000