1111111111111111111111111111111111111111
1111111111100000000000111111111111111111
1111111111111100000000000000001111111111
1111111111111100111111000000000001111111
1111000000000001111111111111000000001111
1100001111100111111111111111111100000011
1000111111100111111111111111111001111111
1001111111100000001111111111111000111111
1100111111000111000011111111110000000111
1100000000011111110000000000000111110001
1111100000011111111001111110001111111001
1111111110011111110011111111001111111001
1111111110001111100011111111001111110001
1111111111100000000001111110000000000011
1111111111111111111100011000011110011111
1111111111111111111111000011111111111111