000000000000000000011111000000000
000000001111000000111111000000000
000000011111110000111111100000000
000000011111110001111111100000000
000000011111111001111111100000000
000000011111111101111111100000000
000000011111111101111111100110000
000000011111111101111111101111100
000111011111111101111111101111110
001111101111111101111111101111110
011111111111111101111110011111110
011111111101110001110000011111110
011111111110001111111100011111110
011111111110001111111100011111110
001111111110011111111110011111110
000111111110111111111110000111100
000111111101111111111111000111000
000011111011111111111111111000000
000000000111111111111111111100000
000000001111111111111111111100000
000000001111111111111111111100000
000000011111111111111111111100000
000000011111111111111111111100000
000000011111111111111111111000000
000000011111111111111111111000000
000000001111111111000000000000000
000000000111111000000000000000000
