00000000000000000000000000001111111100000000000
00000000000000000111111000111111111111000000000
00000000000011111111111100011111111110000000000
00000000001111111111111000011011111110000000000
00000000011101111111011000111111111110000000000
00000000111101111111111110111111111110000000000
00000000011110111111111110111111111100000000000
00000000001110001111111100011111110000000000000
00000001111110000011110000000001110000000000000
00000000011000000011100000000011111000000000000
00000000000000011111110000000111111100000000000
00000000000000111111111000001111111110000000000
00000000000000111111111000011101111110000000000
00000000000001111101111000011110111111000000000
00000000000001111111111000011111011111000000000
00000000000111101111111000011111101111000000000
00000000001111011111111000011111110111100000000
00000000001110111111110000011111111111100000000
00000000011101111111100000011111111101110000000
00000000111111111111000000001111111111011000000
00000000110111111111000000000111111111101100000
00000000011111111111000000000011111111110111000
00000001111111111111000000000001111111110111100