1111111111111111111111111111111
1100011111111111111111111111111
1100001111111111111111111100111
1100001111111111111111111000011
1110000111111111111111110000011
1110000111111111111111110000111
1111000011110001111111100000111
1111000011100001000011100001111
1111100001100001000011000001111
1111110000100001000011000011111
0011111000100001000010000011111
0000110000000000000000000011111
0000000000000000000000000111111
1100000000000000000000000111111
1111000000000000000000000111111
1111000000000000000000001111111
1111100000000000000000001111111
1111110000000000000000011111111
1111110000000000000000111111111
1111111111111111111111111111111