00000000000000000000000001000000000000000000000000
00000000000000000000000111110000000000000000000000
00000000000000000000000001000000000000000000000000
00000000000000000000000001000000000000000000000000
00000000000000000000000111110000000000000000000000
00000000000000000000000001000000000000000000000000
00000000000000000000000001000000000000000000000000
00000000000000000000000011100000000000000000000000
00000000001110000000001111110000000000111000000000
00000000001100000011111111111111100000010000000000
00000000001110001111111111111111111000111000000000
00000000001100001111111111111111111000011000000000
00000000011111000111111111111111110001111100000000
00000111111111111011111111111111101111111111110000
00000111111111111111111110111111111111111111111000
00000011111111111011111000001111101111111111100000
00000001111111100011111111111111100011111111000000
00000001110001100011111111111111100011000111000000
00000001111111100011111111111111100011111111000000
00000011111111111111111111111111111111111111100000
01111111111111111111111111111111111111111111111111
00101111111111111101111111111111011111111111111010
00110100000000001101000000000001000000000000001010
00101100001101110101001101011011010101101011001010
00101111001101111101110011111111011110111110110010
00101111001100111101110011100111011110111111111010
00101111001111111001110011110111011111111111110010
00111111111111111111111111111111111111111111111110
00111100011111000000010111111000000011111111000010
00111100011111000000010111110000000011111100000010
00111100011111000000010111110000000011111100000110
00111111111111111111111111111111111111111111111110
00000000000000000000000000000000000000000000000000