0000000000000000000000000000000
0000111000000000000000001110000
0001111100000000000000011111000
0001111100000000000000011111000
0001111100000000000000011111000
0001111100000000000000011111000
0001111100000000000000011111000
0001111100000000000000011111000
0001111100111100011110011111000
0001111101111110111111011111000
0001111101111110111111011111000
0001111101111110111111011111000
0001111101111110111111011111000
0001111101111000000000000000000
0001111101110011111111111110000
0001111101100111111111111111000
0001111110001111111111111111100
0001111111100111111111111111110
0001111111111001111111111111110
0001111111111110011111111111110
0001111111111111001111111111100
0001111111111111101111111111100
0001111111111111110111111111100
0001111111111111110111111111000
0000111111111111111111111110000
0000011111111111111111111100000
0000000000000000000000000000000