111111111111111111111111111111111
111110000111111111111111000011111
111100011110011010101101110001111
111000111110101010101101111000111
110001111110011010101101111100011
100011111110101010101101111110001
000011111110011101100100111110000
000011111111111111111111111110000
000000111111100000001111111000000
000000000000000000000000000000000
000000000000000000000000000000000
100000000000000000000000000000001
110000100000000000000000001000011
111111100000000000000000001111111
111111000011110000011110000111111
111111000001110000011100000111111
111111000000110000011000000111111
111111100000000000000000001111111
111111110000000000000000011111111
111111111000000000000000111111111
111111111100000000000001111111111
111111111110000000000011111111111
111111111100011111110001111111111
111111111100010000010001111111111
111111111110001000100011111111111
111111111111000000000111111111111
111111111111111111111111111111111 