00000000010000000000000000000000000000000000000000000000000
00000000111000000000000000000000000000000000000000000000000
00000010111110000000000000000000000000000000000000000000000
00000011111111100000000000000000000000000000000000000000000
00000001111111111000000000000000000000000000000000000000000
00000000111111111110000000000000000000000000000000000000000
00000000011111111100000000000000000000000000000000000000000
00000000011111111100000000000000000000000000000000000000000
00000000001111111111000000000000000000000000000000000000000
00000000011111111111000000000000000000000000000000000000000
00000000011111111111110000000000000000000000000000000000000
00000000011111111111111000000000000000000000000000000000000
00000000011111111111111111000000000000000000000000000000000
00000000011111111111111011111000000000000000000000000000000
00000000011111111111111111111000000000000000000000000000000
00000000001111111111111111111111100000000000000000000000000
00000000000111111111111111111111111111000000000000000000000
00000000000111111111111111101111111111111000000000000000000
00000000000001111111111111111111111110111100000000000000000
00000000000000111111111111111111111111111110000000000000000
00000000000000111111111111111111111111111111000000000000000
00000000000000011111111111111111111111111110110000000000000
00000000000000011111111111111111111111111111110000000000000
00000000000000001111001110000111111111111111111000000000000
00000000000000000110001110000011111111101111111110000000000
00000000000000000110001110000011111111111111111111100011000
00000000000000000110001110000001111111111111011111111111000
00000000000000000011000111000000111111111111110111111111000
00000000000000001110001100000000011111000111110000000000000
00000000000111111100011100000000001111100001110000000000000
00000000011111111111111100000000000001110000111000000000000
00001111111111111111111111100000000011100000111000000000000
00011111111111111111111111111100000011100000001110000000000
00111111111111111111111111111111111111000000011100000000000
01111111111111111111111111111111111111110000011100000000000
01111111111111111111111111111111110111111111101110000000000
01111111111111111111111111111111111111111111111110000000000
01111111111111111111111111111111111111111111111111100000000
01111111111111111111011111111111111111111111111111111111111
