00000000000000111111110111110000000000000000
00000000000001111111110111111100000000000000
00000000000011111111110011111111000000000000
00000000000111000011111111111111110000000000
00000000000110000001111111111111110000000000
00000000000110000011111111111111111000000000
00000000000011000111111111111111110000000000
00000000000001111111111111111111100000000000
00000000000000111111111111111110000000000000
00001111100000011111111111111000001111110000
00111111111100000111111111100001111111111100
01111000001111110001111110001111111111111110
01110000001111111111111111111111111111111110
01110111111111111111111111111111111111111110
01111111111111111111111111011111111111111110
00111111111111111111110011000111111111111100
00000111111111111111010011100000111111100000
00000111111111111110010001110000001111100000
00000111111111111100011000110000000111110000
00001111111111111100011000011000000011110000
00000111111111111000011100001110000011100000
00000011111111110000011110000111111111000000
00000000111111000000001111000001111100000000
00000000000000000000000111110000000000000000
00000000000000000000000001100000000000000000