0000000000111000000000000
0000111111111111111110000
1111111100111001111111110
1111111100111000000000111
1111111100111000000000001
0000111111111111111110000
1000000000111000011111111
1110000000111000011111111
1111111110111000011111111
0001111111111111111100000
0000000000111000000000000