000010000
000111000
001101100
011000110
111111111
011111110
010010010
010010010
011110010
011110010