0000000011111111110110000110000000000
0000000011001100110110000110000000000
0000000000001100000111110110000000000
0000000000001100000110011110000000000
0000000000011110000111110110000000000
0000000000000000000000000000000000000
0001111001100110111111011111011111000
0011001101100110110011011000011001100
0011000000111110110011011110011111000
0011001100000110110011011000011000000
0001111000111100110011011111011000000