000000011110000
000000111111000
101000110011000
101001101101100
101001101101100
011101101001100
011101101111000
011101110111000
001111111111100
111111111111111
