000010100000
000101000000
000010000000
000101000000
000010100000
000010100000
111111111100
111111111111
111111111101
111111111101
011111111001
011111111110
001111110000
001111110000
000111100000
