111111111111111
111111111111111
111000000000111
110000000000011
110000000000011
100011111110001
100010000010001
100110000011001
111100000001111
110000111000011
110001111100011
110001111100011
110000111000011
110000000000011
111111111111111