000000000111000
000000001110001
000000011100001
000001111100011
000111111000111
001101111110110
011110111111110
110110111111110
111110111110011
011101111100011
000111111100011
000011111000001
000000111100001
000000011110000
000000000111000
